1111111111111111111111111111111111
1E00000000000000000000000000000001
10C00101001000001010010000C0010101
101001001010101000100100000001E101
1P0000000000000000000000C000000001
1111111111111111111111111111111111
